########
#......#
#C.....#
#G.....#
#..R...#
########