#####
#...#
#CR.#
#G..#
#####
